  t  @    H        A n   
  g    tk     b  d       
  g   tk   t gga d   d   
  g  tk   gaaag  d r     
 akkak3d                 
             h2 YOOOOOU  
    A        hwdaa      x
             h gg      YU
  m        m             
 gg   H            t   a 
             m 8bP       
  A           YOUg       
8                   A    
a       A                
P                 H      
