aaa  @                aaa
aa                      a
a  g   ------------    aa
a                       a
aa    .            .  q a
aaaaaaa           aaaaa a
aaa                     a
a                       a
a                       a
 .x                      
aaaa                   aa
aa                      a
a                       a
a                       a
a                      aa
