@##     #########   e   t
YUg     YUgYOOOOU        
 aP        eg   t        
 a   ###    a            
 at  YOU    a            
 a    a     1        e   
 18   at      n          
              ##x#P# e###
t     ###     eYOOOU  YOU
      YOU        a2    a 
       a         a     a 
       1         a     1 
                 a       
                 1       
m  gg                m   
