OOOOOOOOOOOOOOOOOOOOOOOOa
 8   tt a# tt #a tt   8 a
4 #     a     xa     # 6a
 #aaaggaaaaggaaaaggaaa# a
  a                  a  a
t g   m    n      m  g ta
  a                  a  a
  a                  a  a
aaa                  aaaa
  a                  a  a
t g  m      m    n   g ta
  a                  a  a
 #aaaggaaaaggaaaaggaaa# a
4 #     a      a     # 6a
 2   t @a# tt #a tt   2 a
