..............[..........
              w          
a---a         w          
a   a         w     t    
ar  a         w    t     
aa aaOOOOOOOOOwOOOOOU>>>>
6           yg       t   
             y   ^       
   d     2e     ^        
OOUgYOU>>YOOOOOOOOOOUgYOO
                    g  cg
c     2     h     8 g 8 g
OOOOOOOOOOOUhYOU<<YOOOUdY
@         6 h 4    t  x  
OOOOOOOOOOOOOOOOOOOOOOOOO
