            YU           
 t     e  e    e       t 
     1AAAAAAAAAAAAAA7    
  e  A1AAAAAAAAAAAA7A    
     AA     88     AA  e 
     AA     22@    AAe   
U    AA   46YU46   AA   Y
   n AA   46aa46   AA    
     AA     88     AAm   
   e AA     22     AA e  
     A3AAAAAAAAAAAA9A    
     3AAAAAAAAAAAAAA9    
 t         e           tx
      e     YU m  e    YU
                         
