     @  h    @     @     
     YOOOOOOOOOOOOOU     
  @  )      a       4 @  
     YOU a        YOU    
a a    a vYOOOU   r      
a a        ak     a      
aka        aaaa @ a  v   
aOa  v      v@  YOa      
r B             1a       
       @ @ @     a       
        h        a       
    @   h  a    a   @ 8@ 
 6YOOOUvh  aK     YOOOOOU
        h  aOUE   a@   X 
      @ h         aOOOOU 
