aaaaaaaaaaaaacaaaaaaaaaaa
            t            
            g 8          
   m         aa      n   
                    n    
n   m m                  
a6             n   m    x
a  m  m   m n        m   
c   n    n      n       n
        m  n        m    
n   m            m     YU
        n n  m          r
         m         m  m  
@                       c
OOOOOOOOOOOOOOOOOOOOOOOOO
