aOcah      m        haOOa
a  Xh   f  m    m   hX ta
a@.ah XYOOOOOOOOgU  ha xa
aOOah  a2 r afa  a  haOOa
a qXh  g    afa  g  hX  a
a. ah Ps  8  f   a  ha  a
asOahggaffatawa  a  hacOa
a  Xh mgwwatawtaagt hX  a
s. gh na  a    t ae hg. s
aOOah  a  aOOOggOa  haOOa
a  Xh  gR       Rg  hX  a
a  ah  aa>>>>>>>aa  haq a
aOOah               haOOa
       W   7 3   W .     
    a9YOOOOU YOOOOU9OW   
