     @aBaBaa   y         
              y## ^#     
4    #       y     ^ # # 
# # # # # # #   #    y # 
#    #aaCaCa        y#   
 6 # 2 #        8# #     
#    >>>#                
 8# # # # # # # 4       c
8 #   # 4       #        
aaaacaaaaaaaaa   ]      &
ax   gf      aP #       &
agggggf      aS         &
a t  gfS   @ra  #       &
aaaaaasaaaaaaa4         &
             8  #       t
