  a   u               a  
  a       cccccc      a  
  a                   a  
  a  @   2      8     a  
  accccaccc----ccccccca  
  a       c    D     xa  
  a       E    c      a  
  a gg    <<<<<<      7  
  a                   a  
  a       c           a  
  a   gg              a  
  a                   a  
  a    n  n     gg    a  
  a                   a  
  3       >>>>>>      a  
