aaaaaa                   
aS@m 2g      m           
a    a    m n   YOOU    x
a8   gd   ta    a##a     
aOOOOa   aaa    a##a     
    A     m n   a##a     
        r       t##a     
 A  YUcYOUgYU  aa]]a     
    a  @a   a  Aa[[a     
    a  sa   a   a  7     
    a8   g ta   a##a     
    cOU>YOU dm  a##a     
        PSc a   a##t6    
     A    aka   a##aa    
          cOac  a##aA    
