a                        
a@ .                 . h 
aOOOOOOOOOOOOOOOOOOOOOUha
   wwwg a      .       ha
   wiwg a-----aaa      ha
 t wwwg .       a  a . ha
a YOOOOOOOOOOOOOOOOOOOOaa
       g .     .2  c  n  
 .     g       d         
     . c 8t      . P  m  
U>>>>YOaOOOOOUs 7YOOOOOOO
 f h ~~~~~~g  .s  r   . X
 s hg~~~~~~gggggggggggggg
.R hg~~x~~~g  KgE  g    g
OOOOOOOOOOOOOOOOOOOOOOOOO
